WWWWWWWWWWWWWWWWWWWW
W-----W--W----WW---W
W------------------W
WW--WWWWWW--WWW---WW
W---W--WWW--W------W
WW------W---W--WW-WW
W---WWW-----W------W
W---WWWWWW--WWWWW-WW
W---W-DWW---W------W
WW--W----WW-WWWWW-WW
WW--WWWW----------WW
W---WWWWWW--WWW----W
W-------------W----W
W---WWWW-WWWW-W----W
W---W--W-W--W-W----W
WW--W-------W-W---WW
WW--WWWWWWWWW-WWW--W
W-----------------WW
W-W---WW----WW-----W
WWWWWWWWWWWWWWWWWWWW