WWWWWWWWWWWWWW
W............W
W............W
W............W
W............W
W............W
W............W
W............W
W............W
W............W
W............W
W............W
W............W
WWWWWWWWWWWWWW