WWWWWWWWWWWWWWWWWWWW
W---W--------------W
W-W-W-WWWWWWWWWWW-WW
W-W---W---W----W---W
W-WWW-W-W-W-WW-W---W
W---W-W-W-W-W------W
WWW-WWW-WWW-W-WWWWWW
W-----W.....W-W----W
W-WWW-W..D..W-WW-WWW
W-W---W.....W------W
W-W-WWW-WWWWWWW-WWWW
W-W-----W-----W----W
W-WWWWWWW-W-WWW-WWWW
W---------W--------W
WWWWW-WWWWW-WWWWWWWW
W-W-------W---W---WW
W---WWW-WWWWW---W-WW
W-W-W-----W---W-W--W
W-W-W-W-W-W-W-W-W--W
WWWWWWWWWWWWWWWWWWWW