WWWWWWWWWWWWWWWWWWWWWWWWW
W-----W--W--------------W
W-----------------------W
WW--WWWWWW-------------WW
W---W--WWW--------------W
WW------W--------------WW
W---WWW-----------------W
W---WWWWWW-------------WW
W---W-DWW---------------W
WW--W----WW------------WW
WW--WWWW---------------WW
W---WWWWWW--------------W
W-----------------------W
W-----------------------W
W-----------------------W
W-----------------------W
W-----------------------W
W-----------------------W
W-----------------------W
W-----------------------W
W-----------------------W
W-----------------------W
W-----------------------W
W-----------------------W
WWWWWWWWWWWWWWWWWWWWWWWWW