WWWWWWWWWWWWWW
W....W.......W
W.WW...W.WWW.W
W...WW.W.....W
W..W...WW.WWWW
WWWW.WWW.....W
W........W.W.W
W.W.WWW.WW.W.W
W.W.W...W..W.W
W.W.W.W......W
W.W...W.WWWWWW
W.WWWWWWW....W
W............D
WWWWWWWWWWWWWW