WWWWWWWWWWWWWWWWWWWW
W..................W
W...WWWWWWWWWWWW...W
W...W----W-WW--W...W
WW-WW-WW-W-----W...W
W-----WW-W-W---W...W
W-WWW-WW-WWWW--W...W
W-W-W----------W.WWW
W---W--WWW-WW--W.W-W
W-WWW--W---WW--W.--W
W-W---WW---WW--W.W-W
W---W------W---W.WWW
WWWWWW-WWWWWWWWW...W
W..................W
WWWWWW...WW-W...WWWW
W----W...W--W...W--W
W-WW-WWWWW-WWWWW---W
W-WW----W-----W----W
W-----W-----W---W-WW
WWWWWWWWWDWWWWWWWWWW