WWWWWWWWWWWWWW
W...--W------W
W...W-W-WW---W
W...W----W-WWW
WW-WW-WW-W---W
W-----WW-W-W-W
W-----DW-----W
W-WWW-WW-WWWWW
W-W-W--------W
W---W--WWW-WWW
W-WWW--W.....W
W-W---WW.....W
W---W---.....W
WWWWWWWWWWWWWW